2019	ğ¥’ğ¥ğ¥‘ğ¥™
23	ğ¥’ğ¥“
0123456789  ğ¥ğ¥‘ğ¥’ğ¥“ğ¥”ğ¥•ğ¥–ğ¥—ğ¥˜ğ¥™
Al	ğ¤€ğ¤¤
Alla	ğ¤€ğ¤¤ğ¥†ğ¤¢
Ammbaasad	ğ¤€ğ¤¥ğ¤¦ğ¤¢ğ¥„ğ¤§ğ¤¢ğ¤£
Baaba	ğ¤„ğ¤¢ğ¥„ğ¤¦ğ¤¢
Buubakar	ğ¤„ğ¤µğ¥…ğ¤¦ğ¤¢ğ¤³ğ¤¢ğ¤ª
Daande	ğ¤ğ¤¢ğ¥„ğ¤²'ğ¤£ğ¤«
E	ğ¤‰
Ene	ğ¤‰ğ¤²ğ¤«
GISE	ğ¤˜ğ¤‹ğ¤…ğ¤‰
GOONGA	ğ¤˜ğ¤Œğ¥…ğ¤'ğ¤˜ğ¤€
Gila	ğ¤˜ğ¤­ğ¤¤ğ¤¢
Gise	ğ¤˜ğ¤­ğ¤§ğ¤«
Goonga	ğ¤˜ğ¤®ğ¥…ğ¤²'ğ¤ºğ¤¢
Hajji	ğ¤–ğ¤¢ğ¤¶ğ¥†ğ¤­
Hammee	ğ¤–ğ¤¢ğ¤¥ğ¥†ğ¤«ğ¥…
Hay	ğ¤–ğ¤¢ğ¤´
Ibiraahiima	ğ¤‹ğ¤¦ğ¤­ğ¤ªğ¤¢ğ¥„ğ¤¸ğ¤­ğ¥…ğ¤¥ğ¤¢
Ii	ğ¤‹ğ¥…
Jaabawol	ğ¤”ğ¤¢ğ¥„ğ¤¦ğ¤¢ğ¤±ğ¤®ğ¤¤
JoomiraaÉ—o	ğ¤”ğ¤®ğ¥…ğ¤¥ğ¤­ğ¤ªğ¤¢ğ¥„ğ¤¯ğ¤®
KAALDEN	ğ¤‘ğ¤€ğ¥„ğ¤‚ğ¤ğ¤‰ğ¤
Kaalden	ğ¤‘ğ¤¢ğ¥„ğ¤¤ğ¤£ğ¤«ğ¤²
Kanko	ğ¤‘ğ¤¢ğ¤²ğ¤³ğ¤®
Keytaa	ğ¤‘ğ¤«ğ¤´ğ¤¼ğ¤¢ğ¥„
Ko	ğ¤‘ğ¤®
Kono	ğ¤‘ğ¤®ğ¤²ğ¤®
Laamu	ğ¤‚ğ¤¢ğ¥„ğ¤¥ğ¤µ
Leydi	ğ¤‚ğ¤«ğ¤´ğ¤£ğ¤­
LeÃ±ol	ğ¤‚ğ¤«ğ¤»ğ¤®ğ¤¤
Lih	ğ¤‚ğ¤­ğ¤¸
Maa	ğ¤ƒğ¤¢ğ¥„
Maal	ğ¤ƒğ¤¢ğ¥„ğ¤¤
Makki	ğ¤ƒğ¤¢ğ¤³ğ¥†ğ¤­
Malal	ğ¤ƒğ¤¢ğ¤¤ğ¤¢ğ¤¤
Mali	ğ¤ƒğ¤¢ğ¤¤ğ¤­
Mbele	ğ¤'ğ¤„ğ¤«ğ¤¤ğ¤«
MboÉ—o	ğ¤'ğ¤„ğ¤®ğ¤¯ğ¤®
Muritani	ğ¤ƒğ¤µğ¤ªğ¤­ğ¤¼ğ¤¢ğ¤²ğ¤­
NjiÉ—-mi	ğ¤'ğ¤”ğ¤­ğ¤¯-ğ¤¥ğ¤­
NjiÉ—-É—en	ğ¤'ğ¤”ğ¤­ğ¤¯-ğ¤¯ğ¤«ğ¤²
Pulaagu	ğ¤†ğ¤µğ¤¤ğ¤¢ğ¥„ğ¤ºğ¤µ
Pulaar	ğ¤†ğ¤µğ¤¤ğ¤¢ğ¥„ğ¤ª
Rewa	ğ¤ˆğ¤«ğ¤±ğ¤¢
Sabu	ğ¤…ğ¤¢ğ¤¦ğ¤µ
Sal	ğ¤…ğ¤¢ğ¤¤
Sammba	ğ¤…ğ¤¢ğ¤¥ğ¤¦ğ¤¢
Senegaal	ğ¤…ğ¤«ğ¤²ğ¤«ğ¤ºğ¤¢ğ¥„ğ¤¤
SenegaalnaaÉ“e	ğ¤…ğ¤«ğ¤²ğ¤«ğ¤ºğ¤¢ğ¥„ğ¤¤ğ¤²ğ¤¢ğ¥„ğ¤©ğ¤«
Sikke	ğ¤…ğ¤­ğ¤³ğ¥†ğ¤«
So	ğ¤…ğ¤®
SukaaÉ“e	ğ¤…ğ¤µğ¤³ğ¤¢ğ¥„ğ¤©ğ¤«
Tabital	ğ¤šğ¤¢ğ¤¦ğ¤­ğ¤¼ğ¤¢ğ¤¤
Tawde	ğ¤šğ¤¢ğ¤±ğ¤£ğ¤«
Tonngirten	ğ¤šğ¤®ğ¤²ğ¤ºğ¤­ğ¤ªğ¤¼ğ¤«ğ¤²
Winndannde	ğ¤ğ¤­ğ¤²ğ¤£ğ¤¢ğ¤²ğ¤£ğ¤«
Won	ğ¤ğ¤®ğ¤²
Yanti	ğ¤’ğ¤¢ğ¤²ğ¤¼ğ¤­
a	ğ¤¢
aan	ğ¤¢ğ¥„ğ¤²
aaÉ“notonoo	ğ¤¢ğ¥„ğ¤©ğ¤²ğ¤®ğ¤¼ğ¤®ğ¤²ğ¤®ğ¥…
ajaande	ğ¤¢ğ¤¶ğ¤¢ğ¥„ğ¤²'ğ¤£ğ¤«
alaa	ğ¤¢ğ¤¤ğ¤¢ğ¥„
alaanaa	ğ¤¢ğ¤¤ğ¤¢ğ¥„ğ¤²ğ¤¢ğ¥„
am	ğ¤¢ğ¤¥
ammbaasduuji	ğ¤¢ğ¤¥ğ¤¦ğ¤¢ğ¥„ğ¤§ğ¤£ğ¤µğ¥…ğ¤¶ğ¤­
anndi	ğ¤¢ğ¤²ğ¤£ğ¤­
anndunooÉ“e	ğ¤¢ğ¤²ğ¤£ğ¤µğ¤²ğ¤®ğ¥…ğ¤©ğ¤«
arde	ğ¤¢ğ¤ªğ¤£ğ¤«
ardiiÉ“e	ğ¤¢ğ¤ªğ¤£ğ¤­ğ¥…ğ¤©ğ¤«
aroowo	ğ¤¢ğ¤ªğ¤®ğ¥…ğ¤±ğ¤®
aÉ—a	ğ¤¢ğ¤¯ğ¤¢
baawÉ—o	ğ¤¦ğ¤¢ğ¥„ğ¤±ğ¤¯ğ¤®
ballal	ğ¤¦ğ¤¢ğ¤¤ğ¥†ğ¤¢ğ¤¤
baÉ—oowo	ğ¤¦ğ¤¢ğ¤¯ğ¤®ğ¥…ğ¤±ğ¤®
baÉ—É—o	ğ¤¦ğ¤¢ğ¤¯ğ¥†ğ¤®
boni	ğ¤¦ğ¤®ğ¤²ğ¤­
caggal	ğ¤·ğ¤¢ğ¤ºğ¥†ğ¤¢ğ¤¤
ceÉ“or-É—en	ğ¤·ğ¤«ğ¤©ğ¤®ğ¤ª-ğ¤¯ğ¤«ğ¤²
ciifi	ğ¤·ğ¤­ğ¥…ğ¤¬ğ¤­
cikkaani	ğ¤·ğ¤­ğ¤³ğ¥†ğ¤¢ğ¥„ğ¤²ğ¤­
cikku-É—en	ğ¤·ğ¤­ğ¤³ğ¥†ğ¤µ-ğ¤¯ğ¤«ğ¤²
citinen	ğ¤·ğ¤­ğ¤¼ğ¤­ğ¤²ğ¤«ğ¤²
daande	ğ¤£ğ¤¢ğ¥„ğ¤²'ğ¤£ğ¤«
dadiiÉ“e	ğ¤£ğ¤¢ğ¤£ğ¤­ğ¥…ğ¤©ğ¤«
daÃ±a	ğ¤£ğ¤¢ğ¤»ğ¤¢
dee	ğ¤£ğ¤«ğ¥…
defaa	ğ¤£ğ¤«ğ¤¬ğ¤¢ğ¥„
deftere	ğ¤£ğ¤«ğ¤¬ğ¤¼ğ¤«ğ¤ªğ¤«
diÉ—É—al	ğ¤£ğ¤­ğ¤¯ğ¥†ğ¤¢ğ¤¤
doggol	ğ¤£ğ¤®ğ¤ºğ¥†ğ¤®ğ¤¤
doole	ğ¤£ğ¤®ğ¥…ğ¤¤ğ¤«
dukaa	ğ¤£ğ¤µğ¤³ğ¤¢ğ¥„
e	ğ¤«
ella	ğ¤«ğ¤¤ğ¥†ğ¤¢
en	ğ¤«ğ¤²
ene	ğ¤«ğ¤²ğ¤«
enen	ğ¤«ğ¤²ğ¤«ğ¤²
etaade	ğ¤«ğ¤¼ğ¤¢ğ¥„ğ¤£ğ¤«
eÉ“e	ğ¤«ğ¤©ğ¤«
eÉ—en	ğ¤«ğ¤¯ğ¤«ğ¤²
faabo	ğ¤¬ğ¤¢ğ¥„ğ¤¦ğ¤®
faamde	ğ¤¬ğ¤¢ğ¥„ğ¤¥ğ¤£ğ¤«
fayannde	ğ¤¬ğ¤¢ğ¤´ğ¤¢ğ¤²ğ¤£ğ¤«
fitinaaji	ğ¤¬ğ¤­ğ¤¼ğ¤­ğ¤²ğ¤¢ğ¥„ğ¤¶ğ¤­
fiyii	ğ¤¬ğ¤­ğ¤´ğ¤­ğ¥…
fiytaade	ğ¤¬ğ¤­ğ¤´ğ¤¼ğ¤¢ğ¥„ğ¤£ğ¤«
fof	ğ¤¬ğ¤®ğ¤¬
fulÉ“e	ğ¤¬ğ¤µğ¤¤ğ¤©ğ¤«
fuÉ—naange	ğ¤¬ğ¤µğ¤¯ğ¤²ğ¤¢ğ¥„ğ¤²'ğ¤ºğ¤«
gaaÃ±iiÉ“e	ğ¤ºğ¤¢ğ¥„ğ¤»ğ¤­ğ¥…ğ¤©ğ¤«
gadanol	ğ¤ºğ¤¢ğ¤£ğ¤¢ğ¤²ğ¤®ğ¤¤
galle	ğ¤ºğ¤¢ğ¤¤ğ¥†ğ¤«
galleeji	ğ¤ºğ¤¢ğ¤¤ğ¥†ğ¤«ğ¥…ğ¤¶ğ¤­
golle	ğ¤ºğ¤®ğ¤¤ğ¥†ğ¤«
goonga	ğ¤ºğ¤®ğ¥…ğ¤²'ğ¤ºğ¤¢
gooto	ğ¤ºğ¤®ğ¥…ğ¤¼ğ¤®
goÉ—É—i	ğ¤ºğ¤®ğ¤¯ğ¥†ğ¤­
gumÉ—o	ğ¤ºğ¤µğ¤¥ğ¤¯ğ¤®
haa	ğ¤¸ğ¤¢ğ¥„
haajii	ğ¤¸ğ¤¢ğ¥„ğ¤¶ğ¤­ğ¥…
haajuuji	ğ¤¸ğ¤¢ğ¥„ğ¤¶ğ¤µğ¥…ğ¤¶ğ¤­
haal	ğ¤¸ğ¤¢ğ¥„ğ¤¤
haala	ğ¤¸ğ¤¢ğ¥„ğ¤¤ğ¤¢
haalaa	ğ¤¸ğ¤¢ğ¥„ğ¤¤ğ¤¢ğ¥„
haalaani	ğ¤¸ğ¤¢ğ¥„ğ¤¤ğ¤¢ğ¥„ğ¤²ğ¤­
haaletee	ğ¤¸ğ¤¢ğ¥„ğ¤¤ğ¤«ğ¤¼ğ¤«ğ¥…
haali	ğ¤¸ğ¤¢ğ¥„ğ¤¤ğ¤­
habrude	ğ¤¸ğ¤¢ğ¤¦ğ¤ªğ¤µğ¤£ğ¤«
hakke	ğ¤¸ğ¤¢ğ¤³ğ¥†ğ¤«
hare	ğ¤¸ğ¤¢ğ¤ªğ¤«
hattan	ğ¤¸ğ¤¢ğ¤¼ğ¥†ğ¤¢ğ¤²
hattanaano	ğ¤¸ğ¤¢ğ¤¼ğ¥†ğ¤¢ğ¤²ğ¤¢ğ¥„ğ¤²ğ¤®
hay	ğ¤¸ğ¤¢ğ¤´
haÉ—ir	ğ¤¸ğ¤¢ğ¤¯ğ¤­ğ¤ª
heen	ğ¤¸ğ¤«ğ¥…ğ¤²
heewaani	ğ¤¸ğ¤«ğ¥…ğ¤±ğ¤¢ğ¥„ğ¤²ğ¤­
hiirnaange	ğ¤¸ğ¤­ğ¥…ğ¤ªğ¤²ğ¤¢ğ¥„ğ¤²'ğ¤ºğ¤«
hulata	ğ¤¸ğ¤µğ¤¤ğ¤¢ğ¤¼ğ¤¢
humpito	ğ¤¸ğ¤µğ¤¥ğ¤¨ğ¤­ğ¤¼ğ¤®
hunuko	ğ¤¸ğ¤µğ¤²ğ¤µğ¤³ğ¤®
huutoraade	ğ¤¸ğ¤µğ¥…ğ¤¼ğ¤®ğ¤ªğ¤¢ğ¥„ğ¤£ğ¤«
innitortooÉ“e	ğ¤­ğ¤²ğ¥†ğ¤­ğ¤¼ğ¤®ğ¤ªğ¤¼ğ¤®ğ¥…ğ¤©ğ¤«
jaabawol	ğ¤¶ğ¤¢ğ¥„ğ¤¦ğ¤¢ğ¤±ğ¤®ğ¤¤
jaÉ“ataa	ğ¤¶ğ¤¢ğ¤©ğ¤¢ğ¤¼ğ¤¢ğ¥„
jaÉ“É“e	ğ¤¶ğ¤¢ğ¤©ğ¥†ğ¤«
jeyaa	ğ¤¶ğ¤«ğ¤´ğ¤¢ğ¥„
jibinde	ğ¤¶ğ¤­ğ¤¦ğ¤­ğ¤²'ğ¤£ğ¤«
jogiindi	ğ¤¶ğ¤®ğ¤ºğ¤­ğ¥…ğ¤²'ğ¤£ğ¤­
jojjaani	ğ¤¶ğ¤®ğ¤¶ğ¥†ğ¤¢ğ¥„ğ¤²ğ¤­
jojjanÉ—e	ğ¤¶ğ¤®ğ¤¶ğ¥†ğ¤¢ğ¤²ğ¤¯ğ¤«
joom	ğ¤¶ğ¤®ğ¥…ğ¤¥
jooÉ—anii	ğ¤¶ğ¤®ğ¥…ğ¤¯ğ¤¢ğ¤²ğ¤­ğ¥…
joÉ“el	ğ¤¶ğ¤®ğ¤©ğ¤«ğ¤¤
joÉ“el!	ğ¤¶ğ¤®ğ¤©ğ¤«ğ¤¤!
junngu	ğ¤¶ğ¤µğ¤²ğ¤ºğ¤µ
kaalda	ğ¤³ğ¤¢ğ¥„ğ¤¤ğ¤£ğ¤¢
kaalden	ğ¤³ğ¤¢ğ¥„ğ¤¤ğ¤£ğ¤«ğ¤²
kaantoriÉ—É—e	ğ¤³ğ¤¢ğ¥„ğ¤²ğ¤¼ğ¤®ğ¤ªğ¤­ğ¤¯ğ¥†ğ¤«
kaaÉ—oo	ğ¤³ğ¤¢ğ¥„ğ¤¯ğ¤®ğ¥…
kadi	ğ¤³ğ¤¢ğ¤£ğ¤­
kala	ğ¤³ğ¤¢ğ¤¤ğ¤¢
kam	ğ¤³ğ¤¢ğ¤¥
kanko	ğ¤³ğ¤¢ğ¤²ğ¤³ğ¤®
kay	ğ¤³ğ¤¢ğ¤´
kaÃ±um	ğ¤³ğ¤¢ğ¤»ğ¤µğ¤¥
kaÉ—a	ğ¤³ğ¤¢ğ¤¯ğ¤¢
kaÉ—at	ğ¤³ğ¤¢ğ¤¯ğ¤¢ğ¤¼
ko	ğ¤³ğ¤®
konngi	ğ¤³ğ¤®ğ¤²ğ¤ºğ¤­
konngol	ğ¤³ğ¤®ğ¤²ğ¤ºğ¤®ğ¤¤
kono	ğ¤³ğ¤®ğ¤²ğ¤®
koo	ğ¤³ğ¤®ğ¥…
koolii	ğ¤³ğ¤®ğ¥…ğ¤¤ğ¤­ğ¥…
koÉ—diiÉ—o	ğ¤³ğ¤®ğ¤¯ğ¤£ğ¤­ğ¥…ğ¤¯ğ¤®
laamanaaki	ğ¤¤ğ¤¢ğ¥„ğ¤¥ğ¤¢ğ¤²ğ¤¢ğ¥„ğ¤³ğ¤­
laamu	ğ¤¤ğ¤¢ğ¥„ğ¤¥ğ¤µ
laamÉ“e	ğ¤¤ğ¤¢ğ¥„ğ¤¥ğ¤©ğ¤«
laamÉ—o	ğ¤¤ğ¤¢ğ¥„ğ¤¥ğ¤¯ğ¤®
laawol	ğ¤¤ğ¤¢ğ¥„ğ¤±ğ¤®ğ¤¤
laaÉ“	ğ¤¤ğ¤¢ğ¥„ğ¤©
leeÉ“teteengol	ğ¤¤ğ¤«ğ¥…ğ¤©ğ¤¼ğ¤«ğ¤¼ğ¤«ğ¥…ğ¤²'ğ¤ºğ¤®ğ¤¤
lefol	ğ¤¤ğ¤«ğ¤¬ğ¤®ğ¤¤
leydi	ğ¤¤ğ¤«ğ¤´ğ¤£ğ¤­
leyÉ—eele	ğ¤¤ğ¤«ğ¤´ğ¤¯ğ¤«ğ¥…ğ¤¤ğ¤«
leÃ±ol	ğ¤¤ğ¤«ğ¤»ğ¤®ğ¤¤
liggododirtoo	ğ¤¤ğ¤­ğ¤ºğ¥†ğ¤®ğ¤£ğ¤®ğ¤£ğ¤­ğ¤ªğ¤¼ğ¤®ğ¥…
lijitana	ğ¤¤ğ¤­ğ¤¶ğ¤­ğ¤¼ğ¤¢ğ¤²ğ¤¢
lowre	ğ¤¤ğ¤®ğ¤±ğ¤ªğ¤«
ma	ğ¤¥ğ¤¢
maa	ğ¤¥ğ¤¢ğ¥„
makko	ğ¤¥ğ¤¢ğ¤³ğ¥†ğ¤®
mars	ğ¤¥ğ¤¢ğ¤ªğ¤§
maslahaa	ğ¤¥ğ¤¢ğ¤§ğ¤¤ğ¤¢ğ¤¸ğ¤¢ğ¥„
mawngo	ğ¤¥ğ¤¢ğ¤±ğ¤²'ğ¤ºğ¤®
mawÉ“e	ğ¤¥ğ¤¢ğ¤±ğ¤©ğ¤«
mawÉ—o	ğ¤¥ğ¤¢ğ¤±ğ¤¯ğ¤®
mayre	ğ¤¥ğ¤¢ğ¤´ğ¤ªğ¤«
maÉ“É“e	ğ¤¥ğ¤¢ğ¤©ğ¥†ğ¤«
mbaaw-É—en	ğ¤²'ğ¤¦ğ¤¢ğ¥„ğ¤±-ğ¤¯ğ¤«ğ¤²
mbaÉ—aama	ğ¤²'ğ¤¦ğ¤¢ğ¤¯ğ¤¢ğ¥„ğ¤¥ğ¤¢
mbaÉ—ata	ğ¤²'ğ¤¦ğ¤¢ğ¤¯ğ¤¢ğ¤¼ğ¤¢
mbedda	ğ¤²'ğ¤¦ğ¤«ğ¤£ğ¥†ğ¤¢
mbelaa	ğ¤²'ğ¤¦ğ¤«ğ¤¤ğ¤¢ğ¥„
mbele	ğ¤²'ğ¤¦ğ¤«ğ¤¤ğ¤«
mbiy-É—en	ğ¤²'ğ¤¦ğ¤­ğ¤´-ğ¤¯ğ¤«ğ¤²
mbiyen	ğ¤²'ğ¤¦ğ¤­ğ¤´ğ¤«ğ¤²
memaa	ğ¤¥ğ¤«ğ¤¥ğ¤¢ğ¥„
memaama	ğ¤¥ğ¤«ğ¤¥ğ¤¢ğ¥„ğ¤¥ğ¤¢
men	ğ¤¥ğ¤«ğ¤²
mettaa	ğ¤¥ğ¤«ğ¤¼ğ¥†ğ¤¢ğ¥„
mette	ğ¤¥ğ¤«ğ¤¼ğ¥†ğ¤«
mi	ğ¤¥ğ¤­
miijo	ğ¤¥ğ¤­ğ¥…ğ¤¶ğ¤®
miin	ğ¤¥ğ¤­ğ¥…ğ¤²
mo	ğ¤¥ğ¤®
moÆ´Æ´i	ğ¤¥ğ¤®ğ¤°ğ¥†ğ¤­
moÆ´Æ´ol	ğ¤¥ğ¤®ğ¤°ğ¥†ğ¤®ğ¤¤
mum	ğ¤¥ğ¤µğ¤¥
mumen	ğ¤¥ğ¤µğ¤¥ğ¤«ğ¤²
naamnal	ğ¤²ğ¤¢ğ¥„ğ¤¥ğ¤²ğ¤¢ğ¤¤
nafaani	ğ¤²ğ¤¢ğ¤¬ğ¤¢ğ¥„ğ¤²ğ¤­
nanaama	ğ¤²ğ¤¢ğ¤²ğ¤¢ğ¥„ğ¤¥ğ¤¢
nanaani	ğ¤²ğ¤¢ğ¤²ğ¤¢ğ¥„ğ¤²ğ¤­
nanete	ğ¤²ğ¤¢ğ¤²ğ¤«ğ¤¼ğ¤«
nani	ğ¤²ğ¤¢ğ¤²ğ¤­
nanndo	ğ¤²ğ¤¢ğ¤²ğ¤£ğ¤®
nawori	ğ¤²ğ¤¢ğ¤±ğ¤®ğ¤ªğ¤­
nde	ğ¤²'ğ¤£ğ¤«
ndee	ğ¤²'ğ¤£ğ¤«ğ¥…
ndeena	ğ¤²'ğ¤£ğ¤«ğ¥…ğ¤²ğ¤¢
nder	ğ¤²'ğ¤£ğ¤«ğ¤ª
ndi	ğ¤²'ğ¤£ğ¤­
ndii	ğ¤²'ğ¤£ğ¤­ğ¥…
ndimaagu	ğ¤²'ğ¤£ğ¤­ğ¤¥ğ¤¢ğ¥„ğ¤ºğ¤µ
ndimÉ—undi	ğ¤²'ğ¤£ğ¤­ğ¤¥ğ¤¯ğ¤µğ¤²'ğ¤£ğ¤­
ne	ğ¤²ğ¤«
neÉ—É—o	ğ¤²ğ¤«ğ¤¯ğ¥†ğ¤®
ngal	ğ¤²'ğ¤ºğ¤¢ğ¤¤
nganndi	ğ¤²'ğ¤ºğ¤¢ğ¤²ğ¤£ğ¤­
nganndinen	ğ¤²'ğ¤ºğ¤¢ğ¤²ğ¤£ğ¤­ğ¤²ğ¤«ğ¤²
ngarta	ğ¤²'ğ¤ºğ¤¢ğ¤ªğ¤¼ğ¤¢
ngarten	ğ¤²'ğ¤ºğ¤¢ğ¤ªğ¤¼ğ¤«ğ¤²
ngartu	ğ¤²'ğ¤ºğ¤¢ğ¤ªğ¤¼ğ¤µ
ngo	ğ¤²'ğ¤ºğ¤®
ngol	ğ¤²'ğ¤ºğ¤®ğ¤¤
ngolÂ»	ğ¤²'ğ¤ºğ¤®ğ¤¤Â»
ngondi	ğ¤²'ğ¤ºğ¤®ğ¤²'ğ¤£ğ¤­
ngoo	ğ¤²'ğ¤ºğ¤®ğ¥…
ngootiri	ğ¤²'ğ¤ºğ¤®ğ¥…ğ¤¼ğ¤­ğ¤ªğ¤­
ngostondirii	ğ¤²'ğ¤ºğ¤®ğ¤§ğ¤¼ğ¤®ğ¤²'ğ¤£ğ¤­ğ¤ªğ¤­ğ¥…
ngoÉ—ndi	ğ¤²'ğ¤ºğ¤®ğ¤¯ğ¤²'ğ¤£ğ¤­
ngu	ğ¤²'ğ¤ºğ¤µ
ngullitoyo-É—aa	ğ¤²'ğ¤ºğ¤µğ¤¤ğ¥†ğ¤­ğ¤¼ğ¤®ğ¤´ğ¤®-ğ¤¯ğ¤¢ğ¥„
ngummiima	ğ¤²'ğ¤ºğ¤µğ¤¥ğ¥†ğ¤­ğ¥…ğ¤¥ğ¤¢
nii	ğ¤²ğ¤­ğ¥…
njaakorii	ğ¤²'ğ¤¶ğ¤¢ğ¥„ğ¤³ğ¤®ğ¤ªğ¤­ğ¥…
njenna	ğ¤²'ğ¤¶ğ¤«ğ¤²ğ¥†ğ¤¢
njerondirii	ğ¤²'ğ¤¶ğ¤«ğ¤ªğ¤®ğ¤²'ğ¤£ğ¤­ğ¤ªğ¤­ğ¥…
njiyii	ğ¤²'ğ¤¶ğ¤­ğ¤´ğ¤­ğ¥…
njogiindi	ğ¤²'ğ¤¶ğ¤®ğ¤ºğ¤­ğ¥…ğ¤²'ğ¤£ğ¤­
njuÉ“É“innoo	ğ¤²'ğ¤¶ğ¤µğ¤©ğ¥†ğ¤­ğ¤²ğ¥†ğ¤®ğ¥…
no	ğ¤²ğ¤®
noon	ğ¤²ğ¤®ğ¥…ğ¤²
o	ğ¤®
omo	ğ¤®ğ¤¥ğ¤®
onon	ğ¤®ğ¤²ğ¤®ğ¤²
oo	ğ¤®ğ¥…
oya	ğ¤®ğ¤´ğ¤¢
paabo-É—aa	ğ¤¨ğ¤¢ğ¥„ğ¤¦ğ¤®-ğ¤¯ğ¤¢ğ¥„
paaboro-É—aa	ğ¤¨ğ¤¢ğ¥„ğ¤¦ğ¤®ğ¤ªğ¤®-ğ¤¯ğ¤¢ğ¥„
paho	ğ¤¨ğ¤¢ğ¤¸ğ¤®
pot-É—en	ğ¤¨ğ¤®ğ¤¼-ğ¤¯ğ¤«ğ¤²
potno-É—en	ğ¤¨ğ¤®ğ¤¼ğ¤²ğ¤®-ğ¤¯ğ¤«ğ¤²
pullo	ğ¤¨ğ¤µğ¤¤ğ¥†ğ¤®
reedu	ğ¤ªğ¤«ğ¥…ğ¤£ğ¤µ
rewo	ğ¤ªğ¤«ğ¤±ğ¤®
rokkiino	ğ¤ªğ¤®ğ¤³ğ¥†ğ¤­ğ¥…ğ¤²ğ¤®
ronkii	ğ¤ªğ¤®ğ¤²ğ¤³ğ¤­ğ¥…
saabinoo	ğ¤§ğ¤¢ğ¥„ğ¤¦ğ¤­ğ¤²ğ¤®ğ¥…
saaktiima	ğ¤§ğ¤¢ğ¥„ğ¤³ğ¤¼ğ¤­ğ¥…ğ¤¥ğ¤¢
sabu	ğ¤§ğ¤¢ğ¤¦ğ¤µ
saka	ğ¤§ğ¤¢ğ¤³ğ¤¢
seppo	ğ¤§ğ¤«ğ¤¨ğ¥†ğ¤®
sete	ğ¤§ğ¤«ğ¤¼ğ¤«
siftina	ğ¤§ğ¤­ğ¤¬ğ¤¼ğ¤­ğ¤²ğ¤¢
siftinde	ğ¤§ğ¤­ğ¤¬ğ¤¼ğ¤­ğ¤²'ğ¤£ğ¤«
sikki	ğ¤§ğ¤­ğ¤³ğ¥†ğ¤­
sinno	ğ¤§ğ¤­ğ¤²ğ¥†ğ¤®
so	ğ¤§ğ¤®
sukaaÉ“e	ğ¤§ğ¤µğ¤³ğ¤¢ğ¥„ğ¤©ğ¤«
suÉ“ngo	ğ¤§ğ¤µğ¤©ğ¤²'ğ¤ºğ¤®
tabitinii	ğ¤¼ğ¤¢ğ¤¦ğ¤­ğ¤¼ğ¤­ğ¤²ğ¤­ğ¥…
tan	ğ¤¼ğ¤¢ğ¤²
taw	ğ¤¼ğ¤¢ğ¤±
tawa	ğ¤¼ğ¤¢ğ¤±ğ¤¢
tawde	ğ¤¼ğ¤¢ğ¤±ğ¤£ğ¤«
tawi	ğ¤¼ğ¤¢ğ¤±ğ¤­
tawii	ğ¤¼ğ¤¢ğ¤±ğ¤­ğ¥…
tee	ğ¤¼ğ¤«ğ¥…
teski-É—en	ğ¤¼ğ¤«ğ¤§ğ¤³ğ¤­-ğ¤¯ğ¤«ğ¤²
tiitoonde	ğ¤¼ğ¤­ğ¥…ğ¤¼ğ¤®ğ¥…ğ¤²'ğ¤£ğ¤«
to	ğ¤¼ğ¤®
tolnondiri	ğ¤¼ğ¤®ğ¤¤ğ¤²ğ¤®ğ¤²'ğ¤£ğ¤­ğ¤ªğ¤­
toowde	ğ¤¼ğ¤®ğ¥…ğ¤±ğ¤£ğ¤«
tooÃ±annge	ğ¤¼ğ¤®ğ¥…ğ¤»ğ¤¢ğ¤²ğ¤ºğ¤«
totti	ğ¤¼ğ¤®ğ¤¼ğ¥†ğ¤­
tuugniima	ğ¤¼ğ¤µğ¥…ğ¤»ğ¤­ğ¥…ğ¤¥ğ¤¢
tuÆ´Æ´ii	ğ¤¼ğ¤µğ¤°ğ¥†ğ¤­ğ¥…
waajoo	ğ¤±ğ¤¢ğ¥„ğ¤¶ğ¤®ğ¥…
waajotaako	ğ¤±ğ¤¢ğ¥„ğ¤¶ğ¤®ğ¤¼ğ¤¢ğ¥„ğ¤³ğ¤®
waajotoo	ğ¤±ğ¤¢ğ¥„ğ¤¶ğ¤®ğ¤¼ğ¤®ğ¥…
waaju	ğ¤±ğ¤¢ğ¥„ğ¤¶ğ¤µ
waawaa	ğ¤±ğ¤¢ğ¥„ğ¤±ğ¤¢ğ¥„
waawanaa	ğ¤±ğ¤¢ğ¥„ğ¤±ğ¤¢ğ¤²ğ¤¢ğ¥„
waawi	ğ¤±ğ¤¢ğ¥„ğ¤±ğ¤­
walla	ğ¤±ğ¤¢ğ¤¤ğ¥†ğ¤¢
wayi	ğ¤±ğ¤¢ğ¤´ğ¤­
waÉ—atee	ğ¤±ğ¤¢ğ¤¯ğ¤¢ğ¤¼ğ¤«ğ¥…
waÉ—dde	ğ¤±ğ¤¢ğ¤¯ğ¤£ğ¥†ğ¤«
waÉ—de	ğ¤±ğ¤¢ğ¤¯ğ¤£ğ¤«
waÉ—ee	ğ¤±ğ¤¢ğ¤¯ğ¤«ğ¥…
waÉ—i	ğ¤±ğ¤¢ğ¤¯ğ¤­
waÉ—ii	ğ¤±ğ¤¢ğ¤¯ğ¤­ğ¥…
waÉ—ngo	ğ¤±ğ¤¢ğ¤¯ğ¤²'ğ¤ºğ¤®
weejii	ğ¤±ğ¤«ğ¥…ğ¤¶ğ¤­ğ¥…
welaaka	ğ¤±ğ¤«ğ¤¤ğ¤¢ğ¥„ğ¤³ğ¤¢
wiya	ğ¤±ğ¤­ğ¤´ğ¤¢
wiyata	ğ¤±ğ¤­ğ¤´ğ¤¢ğ¤¼ğ¤¢
wiyde	ğ¤±ğ¤­ğ¤´ğ¤£ğ¤«
wiyee	ğ¤±ğ¤­ğ¤´ğ¤«ğ¥…
wiyi	ğ¤±ğ¤­ğ¤´ğ¤­
wiynoo	ğ¤±ğ¤­ğ¤´ğ¤²ğ¤®ğ¥…
won	ğ¤±ğ¤®ğ¤²
wonaa	ğ¤±ğ¤®ğ¤²ğ¤¢ğ¥„
wonde	ğ¤±ğ¤®ğ¤²'ğ¤£ğ¤«
woni	ğ¤±ğ¤®ğ¤²ğ¤­
woodaani	ğ¤±ğ¤®ğ¥…ğ¤£ğ¤¢ğ¥„ğ¤²ğ¤­
woodan	ğ¤±ğ¤®ğ¥…ğ¤£ğ¤¢ğ¤²
woodi	ğ¤±ğ¤®ğ¥…ğ¤£ğ¤­
wooto	ğ¤±ğ¤®ğ¥…ğ¤¼ğ¤®
worgo	ğ¤±ğ¤®ğ¤ªğ¤ºğ¤®
woto	ğ¤±ğ¤®ğ¤¼ğ¤®
wulaango	ğ¤±ğ¤µğ¤¤ğ¤¢ğ¥„ğ¤²'ğ¤ºğ¤®
wulla	ğ¤±ğ¤µğ¤¤ğ¥†ğ¤¢
yaltina	ğ¤´ğ¤¢ğ¤¤ğ¤¼ğ¤­ğ¤²ğ¤¢
yaltude	ğ¤´ğ¤¢ğ¤¤ğ¤¼ğ¤µğ¤£ğ¤«
yeeso	ğ¤´ğ¤«ğ¥…ğ¤§ğ¤®
yenna	ğ¤´ğ¤«ğ¤²ğ¥†ğ¤¢
yettee	ğ¤´ğ¤«ğ¤¼ğ¥†ğ¤«ğ¥…
yimÉ“e	ğ¤´ğ¤­ğ¤¥ğ¤©ğ¤«
yiyi	ğ¤´ğ¤­ğ¤´ğ¤­
yiyii	ğ¤´ğ¤­ğ¤´ğ¤­ğ¥…
yontii	ğ¤´ğ¤®ğ¤²ğ¤¼ğ¤­ğ¥…
yoo	ğ¤´ğ¤®ğ¥…
yooÉ“aade	ğ¤´ğ¤®ğ¥…ğ¤©ğ¤¢ğ¥„ğ¤£ğ¤«
yowitii	ğ¤´ğ¤®ğ¤±ğ¤­ğ¤¼ğ¤­ğ¥…
yoÉ“toraade	ğ¤´ğ¤®ğ¤©ğ¤¼ğ¤®ğ¤ªğ¤¢ğ¥„ğ¤£ğ¤«
Â«	Â«
Â«Ibiraahiima	Â«ğ¤‹ğ¤¦ğ¤­ğ¤ªğ¤¢ğ¥„ğ¤¸ğ¤­ğ¥…ğ¤¥ğ¤¢
Â»	Â»
Ã‘alnde	ğ¤™ğ¤¢ğ¤¤ğ¤²'ğ¤£ğ¤«
Ã±aago-É—en	ğ¤»ğ¤¢ğ¥„ğ¤ºğ¤®-ğ¤¯ğ¤«ğ¤²
Ã±aayde	ğ¤»ğ¤¢ğ¥„ğ¤´ğ¤£ğ¤«
Ã±amlel	ğ¤»ğ¤¢ğ¤¥ğ¤¤ğ¤«ğ¤¤
ÆŠalee	ğ¤ğ¤¢ğ¤¤ğ¤«ğ¥…
É“alndu	ğ¤©ğ¤¢ğ¤¤ğ¤²'ğ¤£ğ¤µ
É“e	ğ¤©ğ¤«
É“ernde	ğ¤©ğ¤«ğ¤ªğ¤²'ğ¤£ğ¤«
É“esngu	ğ¤©ğ¤«ğ¤§ğ¤²'ğ¤ºğ¤µ
É“uri	ğ¤©ğ¤µğ¤ªğ¤­
É—alii	ğ¤¯ğ¤¢ğ¤¤ğ¤­ğ¥…
É—e	ğ¤¯ğ¤«
É—emngal	ğ¤¯ğ¤«ğ¤¥ğ¤²'ğ¤ºğ¤¢ğ¤¤
É—i	ğ¤¯ğ¤­
É—iin	ğ¤¯ğ¤­ğ¥…ğ¤²
É—o	ğ¤¯ğ¤®
É—um	ğ¤¯ğ¤µğ¤¥
É—uum	ğ¤¯ğ¤µğ¥…ğ¤¥
É—uurnaade	ğ¤¯ğ¤µğ¥…ğ¤ªğ¤²ğ¤¢ğ¥„ğ¤£ğ¤«
â€œMaa	â€œğ¤ƒğ¤¢ğ¥„
